encontramos-|nos	encontramos|-nos	encontramo-nos	Calypso|e|encontramos-|nos|em|a
juntar-|se	juntar|-se	juntar-se	,|vêm|juntar-|se|os|montantes
especializarem-|se	especializarem|-se	especializarem-se	é|«|especializarem-|se|em|fundos
Encomendem-|nos	Encomendem|-nos	Encomendem-nos	«|Encomendem-|nos|a|projectistas
compõe-|se	compõe|-se	compõe-se	meses|e|compõe-|se|de|um
destinam-|se	destinam|-se	destinam-se	primeiros|temas|destinam-|se|a|mostrar
destina-|se	destina|-se	destina-se	Lisboa|,|destina-|se|a|permitir
inspira-|se	inspira|-se	inspira-se	Emigrante|»|inspira-|se|em|a
adaptar-|se	adaptar|-se	adaptar-se	não|conseguiam|adaptar-|se|a|o
é-|o	é|-o	é-o	Mas|é-|o|apenas|porque
apresentar-|se	apresentar|-se	apresentar-se	Kasparov|tenta|apresentar-|se|como|o
dividiu-|se	dividiu|-se	dividiu-se	,|ele|dividiu-|se|em|dois
convencionou-|se	convencionou|-se	convencionou-se	Mas|convencionou-|se|que|esta
Sabe-|se	Sabe|-se	Sabe-se	Sabe-|se|lá|o
Registe-|se	Registe|-se	Registe-se	Registe-|se|que|a
recorde-|se	recorde|-se	recorde-se	feriados|(|recorde-|se|que|Soares
apercebeu-|se	apercebeu|-se	apercebeu-se	,|Vítor-Emanuel|apercebeu-|se|que|um
dirigiu-|se	dirigiu|-se	dirigiu-se	,|e|dirigiu-|se|para|o
aponta-|lhe	aponta|-lhe	aponta-lhe	o|príncipe|aponta-|lhe|a|arma
encontra-|se	encontra|-se	encontra-se	aquela|organização|encontra-|se|desde|sexta-feira
Recomenda-|se	Recomenda|-se	Recomenda-se	Recomenda-|se|ainda|a
chamam-|na	chamam|-na	chamam-na	problema|,|chamam-|na
ir-|se	ir|-se	ir-se	acaba|por|ir-|se|em|grande
registar-|se	registar|-se	registar-se	está|a|registar-|se|um|abrandamento
concretizar-|se	concretizar|-se	concretizar-se	,|a|concretizar-|se|,|poderia
fará-|se	fará|-se	far-se-á	a|recolha|fará-|se|«|uma
manter-|se	manter|-se	manter-se	,|irá|manter-|se|a|recolha
adequa-|se	adequa|-se	adequa-se	de|recolha|adequa-|se|a|edifícios
colocam-|se	colocam|-se	colocam-se	E|aí|colocam-|se|novas|dúvidas
esperando-|se	esperando|-se	esperando-se	turismo|,|esperando-|se|dois|milhões
Dizia-|se	Dizia|-se	Dizia-se	Dizia-|se|que|o
leia-|se	leia|-se	leia-se	S.Domingos|[|leia-|se|o|Banco
destaca-|se	destaca|-se	destaca-se	subidas|,|destaca-|se|ainda|o
Movimentaram-|se	Movimentaram|-se	Movimentaram-se	Movimentaram-|se|cerca|de
situar-|se	situar|-se	situar-se	fecho|a|situar-|se|em|os
noticiava-|se	noticiava|-se	noticiava-se	1994|,|noticiava-|se|a|introdução
inclina-|se	inclina|-se	inclina-se	a|polícia|inclina-|se|para|que
substituir-|lo	substituí|-lo	substituí-lo	está|a|substituir-|lo|,|sobretudo
encontram-|se	encontram|-se	encontram-se	Unita|,|encontram-|se|em|a
fecha-|se	fecha|-se	fecha-se	compromissos|e|fecha-|se|em|a
iniciaram-|se	iniciaram|-se	iniciaram-se	mesma|ocasião|iniciaram-|se|investigações|que
incorporar-|lo	incorporá|-lo	incorporá-lo	começar|a|incorporar-|lo|e|dar
tornou-|se	tornou|-se	tornou-se	o|ritmo|tornou-|se|frenético|,
manipularam-|se	manipularam|-se	manipularam-se	,|«|manipularam-|se|mais|de
vendem-|se	vendem|-se	vendem-se	o|quiosque|vendem-|se|de|essas
realizar-|se	realizar|-se	realizar-se	não|deverá|realizar-|se|este|ano
tem-|se	tem|-se	tem-se	Europa|Ocidental|tem-|se|assistido|a
atenuar-|lhes	atenuar|-lhes	atenuar-lhes	tendem|a|atenuar-|lhes|a|envolvência
assinava-|se	assinava|-se	assinava-se	troca|,|assinava-|se|o|contrato-promessa
deu-|lhe	deu|-lhe	deu-lhe	lado|,|deu-|lhe|a|procuração
perguntou-|lhe	perguntou|-lhe	perguntou-lhe	E|Constantino|perguntou-|lhe|se|ele
decidiu-|se	decidiu|-se	decidiu-se	ousadas|,|decidiu-|se|pedir|a
tendo-|lhe	tendo|-lhe	tendo-lhe	alemães|,|tendo-|lhe|sido|colocadas
encontra-|se	encontra|-se	encontra-se	fotógrafos|participantes|encontra-|se|para|um
recriando-|se	recriando|-se	recriando-se	barcos|,|recriando-|se|em|cada
encontra-|se	encontra|-se	encontra-se	armazém|(|encontra-|se|em|sete
ficou-|nos	ficou|-nos	ficou-nos	morta|,|ficou-|nos|só|essa
há-|de	há|de	há-de	»|,|há-|de|ter|sido
tornaram-|se	tornaram|-se	tornaram-se	os|cegos|tornaram-|se|personagens|passionais
Apaixonou-|se	Apaixonou|-se	Apaixonou-se	Apaixonou-|se|por|um
Apraz-|nos	Apraz|-nos	Apraz-nos	Apraz-|nos|referir|a
Enganei-|me	Enganei|-me	Enganei-me	Enganei-|me|:|não
encontra-|se	encontra|-se	encontra-se	Portugal|encontra-|se|hoje|mergulhado
ter-|se	ter|-se	ter-se	que|parece|ter-|se|instalado|predominantemente
libertar-|se	libertar|-se	libertar-se	Cassandra|soube|libertar-|se|de|o
paralisar-|la	paralisá|-la	paralisá-la	que|ameaçava|paralisar-|la
Parte-|se	Parte|-se	Parte-se	Parte-|se|depois|para
arriscamos-|nos	arriscamo|-nos	arriscamo-nos	criminosos|,|arriscamos-|nos|a|ter
concretizar-|se	concretizar|-se	concretizar-se	mas|poderá|concretizar-|se|mais|depressa
reúnem-|se	reúnem|-se	reúnem-se	Jonas|Savimbi|reúnem-|se|em|Libreville
escapar-|se	escapar|-se	escapar-se	ainda|conseguiu|escapar-|se|e|ver
prestou-|as	prestou|-as	prestou-as	As|declarações|prestou-|as|ontem|durante
Abraça-|se	Abraça|-se	Abraça-se	Abraça-|se|a|o
diz-|lhe	diz|-lhe	diz-lhe	»|,|diz-|lhe|ofegante|,
abraça-|o	abraça|-o	abraça-o	rasgado|,|abraça-|o
destina-|se	destina|-se	destina-se	o|Orçamento|destina-|se|a|despesas
trata-|se	trata|-se	trata-se	Sousa|,|trata-|se|de|um
fazem-|se	fazem|-se	fazem-se	actuar|,|fazem-|se|representar|em
contratou-|o	contratou|-o	contratou-o	O|Sporting|contratou-|o|,|trouxe-
trouxe-|o	trouxe|-o	trouxe-o	o|,|trouxe-|o|para|Lisboa
treinar-|lo	treiná|-lo	treiná-lo	começou|a|treinar-|lo
descobriu-|o	descobriu|-o	descobriu-o	uma|italiana|descobriu-|o
traduziu-|o	traduziu|-o	traduziu-o	Teresa|Pazzolo|traduziu-|o|,|prefaciou-
prefaciou-|o	prefaciou|-o	prefaciou-o	o|,|prefaciou-|o|e|ilustrou-
ilustrou-|o	ilustrou|-o	ilustrou-o	o|e|ilustrou-|o|,|com
faltava-|lhes	faltava|-lhes	faltava-lhes	,|mas|faltava-|lhes|a|adopção
Sabe-|se	Sabe|-se	Sabe-se	Sabe-|se|lá|até
relatar-|lhe	relatar|-lhe	relatar-lhe	polícia|e|relatar-|lhe|como|tudo
traduziram-|se	traduziram|-se	traduziram-se	de|Belém|traduziram-|se|em|uma
estreou-|se	estreou|-se	estreou-se	português|Hélder|estreou-|se|em|o
Bateu-|se	Bateu|-se	Bateu-se	Bateu-|se|bem|,
ganhou-|lhes	ganhou|-lhes	ganhou-lhes	bem|,|ganhou-|lhes|muitos|lances
bateu-|me	bateu|-me	bateu-me	a|bola|bateu-|me|em|as
Pediram-|me	Pediram|-me	Pediram-me	Pediram-|me|para|desenrascar
Tratando-|se	Tratando|-se	Tratando-se	Tratando-|se|de|matérias
recorrendo-|se	recorrendo|-se	recorrendo-se	habitual|,|recorrendo-|se|a|um
lançar-|la	lançá|-la	lançá-la	farinha|e|lançar-|la|«|por
manter-|los	mantê|-los	mantê-los	,|querem|manter-|los|em|a
tornaram-|se	tornaram|-se	tornaram-se	pesada|estrutura|tornaram-|se|insuportáveis|para
anunciava-|se	anunciava|-se	anunciava-se	anunciava-|se|uma|corrida
mantivemos-|nos	mantivemo|-nos	mantivemo-nos	uma|semana|mantivemos-|nos|em|os
destaque-|se	destaque|-se	destaque-se	Giacometti|,|destaque-|se|aquele|em
Fala-|se	Fala|-se	Fala-se	Fala-|se|de|a
pronunciar-|se	pronunciar|-se	pronunciar-se	vão|hoje|pronunciar-|se|sobre|o
apresentou-|se	apresentou|-se	apresentou-se	Mike|Smith|apresentou-|se|em|deficientes
intrometer-|se	intrometer|-se	intrometer-se	como|objectivo|intrometer-|se|em|a
atribuir-|lhe	atribuir|-lhe	atribuir-lhe	LNIV|veio|atribuir-|lhe|mais|responsabilidades
tinham-|se	tinham|-se	tinham-se	mil|casais|tinham-|se|oferecido|,
demitir-|me	demitir|-me	demitir-me	«|Decidi|demitir-|me|hoje
procurar-|se	procurar|-se	procurar-se	,|pode|procurar-|se|em|a
tornara-|se	tornara|-se	tornara-se	seu|executivo|tornara-|se|demasiada
portar-|se	portar|-se	portar-se	E|a|portar-|se|a|a
tornou-|se	tornou|-se	tornou-se	física|)|tornou-|se|suporte|--
Chamaram-|se	Chamaram|-se	Chamaram-se	Chamaram-|se|a|si
Debate-|se	Debate|-se	Debate-se	Debate-|se|agora|se
encontravam-|se	encontravam|-se	encontravam-se	casal|,|encontravam-|se|a|cerca
distribuíu-|se	distribuíu|-se	distribuíu-se	polícia|a|distribuíu-|se|por|a
suicidar-|se	suicidar|-se	suicidar-se	terem|ameaçado|suicidar-|se|com|os
evadiram-|se	evadiram|-se	evadiram-se	35|,|evadiram-|se|,|há
demitir-|se	demitir|-se	demitir-se	forçados|a|demitir-|se|para|assegurar
coloca-|o	coloca|-o	coloca-o	o|processo|coloca-|o|em|a
manifestar-|se	manifestar|-se	manifestar-se	dispostos|a|manifestar-|se|em|a
Atende-|se	Atende|-se	Atende-se	Atende-|se|,|também
autoriza-|se	autoriza|-se	autoriza-se	»|e|autoriza-|se|o|pagamento
arranja-|se	arranja|-se	arranja-se	mal|,|arranja-|se|aí|um
Constata-|se	Constata|-se	Constata-se	«|Constata-|se|que|nem
destinam-|se	destinam|-se	destinam-se	comum|,|destinam-|se|a|assegurar
apresenta-|se	apresenta|-se	apresenta-se	a|formação|apresenta-|se|hoje|em
encontram-|se	encontram|-se	encontram-se	concertos|,|encontram-|se|,|entre
destaca-|se	destaca|-se	destaca-se	Novembro|,|destaca-|se|o|de
deve-|se	deve|-se	deve-se	sua|poluição|deve-|se|ainda|o
mover-|se	mover|-se	mover-se	recomeçou|a|mover-|se|em|direcção
revelar-|se	revelar|-se	revelar-se	,|pode|revelar-|se|uma|arma
transformar-|se	transformar|-se	transformar-se	que|poderá|transformar-|se|em|poiso
limitam-|se	limitam|-se	limitam-se	estes|docentes|limitam-|se|a|leccionar
resolver-|la	resolvê|-la	resolvê-la	não|sabem|resolver-|la
Percebe-|se	Percebe|-se	Percebe-se	Percebe-|se|que|a
animam-|se	animam|-se	animam-se	As|coisas|animam-|se|decididamente|com
sucedem-|se	sucedem|-se	sucedem-se	Os|cantores|sucedem-|se|,|Miguel
centrar-|se-á	centrará|-se	centrar-se-á	A|discussão|centrar-|se-á|em|três
tenta-|se	tenta|-se	tenta-se	o|teatro|tenta-|se|encontrar|a
cria-|se	cria|-se	cria-se	espectáculo|,|cria-|se|um|tempo
cria-|se	cria|-se	cria-se	momento|--|cria-|se|um|tempo
trabalha-|se	trabalha|-se	trabalha-se	cinema|,|trabalha-|se|momento|a
tornando-|se	tornando|-se	tornando-se	»|,|tornando-|se|,|em
juntar-|se-ão	juntarão|-se	juntar-se-ão	e|gigantones|juntar-|se-ão|,|a
passou-|se	passou|-se	passou-se	realidade|,|passou-|se|a|falar
Apaixonei-|me	Apaixonei|-me	Apaixonei-me	«|Apaixonei-|me|imediatamente|por
respondeu-|me	respondeu|-me	respondeu-me	Isabel|respondeu-|me|que|ia
Trata-|se	Trata|-se	Trata-se	Trata-|se|de|a
escutar-|se	escutar|-se	escutar-se	,|pode|escutar-|se|a|obra
tornou-|se	tornou|-se	tornou-se	para|6|tornou-|se|praticamente|em
apresentaram-|se	apresentaram|-se	apresentaram-se	de|Portugal|apresentaram-|se|eficazes|,
manteve-|se	manteve|-se	manteve-se	A|peseta|manteve-|se|em|o
concluí-|a	concluí|-a	concluí-a	Filosofia|;|concluí-|a|em|esse
deparam-|se	deparam|-se	deparam-se	Dorado|,|deparam-|se|agora|com
deu-|se	deu|-se	deu-se	--|,|deu-|se|como|ponto
atravessou-|se	atravessou|-se	atravessou-se	O|carro|atravessou-|se|,|primeiro
pensa-|se	pensa|-se	pensa-se	a|FPJ|pensa-|se|já|em
espera-|se	espera|-se	espera-se	E|espera-|se|o|mesmo
Parece-|me	Parece|-me	Parece-me	Parece-|me|lógico|ligar
encontram-|se	encontram|-se	encontram-se	português|,|encontram-|se|para|falar
dirigir-|se	dirigir|-se	dirigir-se	tentado|a|dirigir-|se|a|o
situando-|se	situando|-se	situando-se	melhorou|,|situando-|se|em|50,9
verificou-|se	verificou|-se	verificou-se	Em|Maio|verificou-|se|um|aumento
nacionaliza-|lo	nacionalizá|-lo	nacionalizá-lo	objectivo|foi|nacionaliza-|lo|,|conserva-
conserva-|lo	conservá|-lo	conservá-lo	lo|,|conserva-|lo|.
regozija-|se	regozija|-se	regozija-se	Saddam|Hussein|regozija-|se|com|o
considerando-|o	considerando|-o	considerando-o	administrativas|,|considerando-|o|uma|boa
acrescentou-|lhe	acrescentou|-lhe	acrescentou-lhe	,|e|acrescentou-|lhe|argumentos|para
vou-|me	vou|-me	vou-me	)|--|vou-|me|contentando|com
degradar-|se	degradar|-se	degradar-se	continuem|a|degradar-|se|»
Sabe-|se	Sabe|-se	Sabe-se	Sabe-|se|que|o
evidenciar-|se	evidenciar|-se	evidenciar-se	começou|a|evidenciar-|se|devido|a
permitir-|lhe	permitir|-lhe	permitir-lhe	modo|a|permitir-|lhe|a|marcação
manifestam-|se	manifestam|-se	manifestam-se	Trabalhadores|municipais|manifestam-|se|por
manifestaram-|se	manifestaram|-se	manifestaram-se	trabalhadores|municipais|manifestaram-|se|ontem|diante
transaccionava-|se	transaccionava|-se	transaccionava-se	o|marco/escudo|transaccionava-|se|a|102,35/102,36
substitui-|lo	substituí|-lo	substituí-lo	acabou|por|substitui-|lo|por|Melli
valorizando-|a	valorizando|-a	valorizando-a	chorinho|,|valorizando-|a|com|sabedoria
encontra-|se	encontra|-se	encontra-se	frio|,|encontra-|se|o|vestido
Revê-|se	Revê|-se	Revê-se	Revê-|se|em|o
Usou-|o	Usou|-o	Usou-o	Usou-|o|em|o
apresenta-|se-|lhe	apresenta|-se|-lhe	apresenta-se-lhe	,|apresenta-|se-|lhe|uma|velha
senta-|se	senta|-se	senta-se	Esta|senhora|senta-|se|junto|de
levá-|las	levá|-las	levá-las	e|procura|levá-|las|até|a
recordar-|lhe	recordar|-lhe	recordar-lhe	começa|a|recordar-|lhe|o|tempo
Recordou-|lhe	Recordou|-lhe	Recordou-lhe	Recordou-|lhe|os|invernos
seguiam-|na	seguiam|-na	seguiam-na	os|admiradores|seguiam-|na|de|longe
Recordou-|lhe	Recordou|-lhe	Recordou-lhe	Recordou-|lhe|quando|,
dar-|lhe	dar|-lhe	dar-lhe	todos|procuravam|dar-|lhe|em|a
reve-|la	revê|-la	revê-la	que|podia|reve-|la|e|abraça-
abraça-|la	abraçá|-la	abraçá-la	la|e|abraça-|la
lembra-|se	lembra|-se	lembra-se	a|senhora|lembra-|se|de|quando
pergunta-|lhe	pergunta|-lhe	pergunta-lhe	»|--|pergunta-|lhe|de|súbito
deu-|me	deu|-me	deu-me	o|cabo|deu-|me|os|binóculos
encontra-|la	encontrá|-la	encontrá-la	baralhada|podemos|encontra-|la|,|por
Diga-|se	Diga|-se	Diga-se	Diga-|se|,|também
lembrando-|se	lembrando|-se	lembrando-se	Deneuve|,|lembrando-|se|de|Buñuel
basta-|nos	basta|-nos	basta-nos	basta-|nos|procurar|compreender
conclui-|se	conclui|-se	conclui-se	páginas|,|conclui-|se|por|«
seguir-|se	seguir|-se	seguir-se	,|deverá|seguir-|se|agora|um
sinto-|me	sinto|-me	sinto-me	bolas|aqui|sinto-|me|logo|melhor
encontra-|se	encontra|-se	encontra-se	O|sistema|encontra-|se|disponível|em
limita-|se	limita|-se	limita-se	organismo|visado|limita-|se|a|propor
Pense-|se	Pense|-se	Pense-se	Pense-|se|em|Kingsley
Pense-|se	Pense|-se	Pense-se	Pense-|se|em|o
Pense-|se	Pense|-se	Pense-se	Pense-|se|em|um
obtém-|se	obtém|-se	obtém-se	fim|,|obtém-|se|uma|série
preparar-|se	preparar|-se	preparar-se	tem|de|preparar-|se|para|o
faze-|lo	fazê|-lo	fazê-lo	não|conseguirá|faze-|lo
mantém-|se	mantém|-se	mantém-se	objectivo|perseguido|mantém-|se|:|prosseguir
mostra-|se	mostra|-se	mostra-se	DECO|)|mostra-|se|preocupada|com
encontram-|se	encontram|-se	encontram-se	festejos|carnavalescos|encontram-|se|os|estalinhos
Encontram-|se	Encontram|-se	Encontram-se	Encontram-|se|em|todo
visita-|la	visitá|-la	visitá-la	venham|a|visita-|la
deslocando-|se	deslocando|-se	deslocando-se	meses|,|deslocando-|se|depois|para
destinava-|se	destinava|-se	destinava-se	contos|e|destinava-|se|a|ser
Espera-|se	Espera|-se	Espera-se	Espera-|se|ainda|a
trata-|se	trata|-se	trata-se	,|e|trata-|se|de|a
acentuando-|se	acentuando|-se	acentuando-se	região|,|acentuando-|se|a|concentração
trata-|se	trata|-se	trata-se	,|e|trata-|se|de|uma
fez-|se	fez|-se	fez-se	previsto|,|fez-|se|a|substituição
Parece-|me	Parece|-me	Parece-me	Parece-|me|que|em
Antevi-|me	Antevi|-me	Antevi-me	Antevi-|me|,|com
contaram-|me	contaram|-me	contaram-me	Depois|,|contaram-|me|que|,
insere-|se	insere|-se	insere-se	,|e|insere-|se|em|a
escreve-|se	escreve|-se	escreve-se	Excelência|»|escreve-|se|em|maiúsculas
trair-|vos	trair|-vos	trair-vos	anda|a|trair-|vos
impondo-|se	impondo|-se	impondo-se	país|,|impondo-|se|um|teste
Recorde-|se	Recorde|-se	Recorde-se	Recorde-|se|que|as
instalar-|se	instalar|-se	instalar-se	começam|a|instalar-|se|em|os
referir-|se	referir|-se	referir-se	a|o|referir-|se|a|as
redimiu-|se	redimiu|-se	redimiu-se	feita|,|redimiu-|se|a|Escola
Lidou-|se	Lidou|-se	Lidou-se	Lidou-|se|um|curro
Recorde-|se	Recorde|-se	Recorde-se	Recorde-|se|que|Edberg
permitiram-|lhe	permitiram|-lhe	permitiram-lhe	relva|londrina|permitiram-|lhe|o|salto
desvincular-|se	desvincular|-se	desvincular-se	a|ameaçar|desvincular-|se|de|o
tem-|se	tem|-se	tem-se	Gerhard|Berger|tem-|se|mostrado|um
aproveitam-|se	aproveitam|-se	aproveitam-se	Burlões|aproveitam-|se|de|o
sentaram-|se	sentaram|-se	sentaram-se	Depois|,|sentaram-|se|o|guarda-redes
avança-|se	avança|-se	avança-se	esta|roda|avança-|se|10|centímetros
Estabelece-|se	Estabelece|-se	Estabelece-se	Estabelece-|se|que|«
Consagra-|se	Consagra|-se	Consagra-se	Consagra-|se|também|o
dividem-|se	dividem|-se	dividem-se	os|participantes|dividem-|se|em|«
deve-|se	deve|-se	deve-se	Isto|deve-|se|possivelmente|a
lembrou-|se	lembrou|-se	lembrou-se	Miller|Guerra|lembrou-|se|,|a
Peço-|lhes	Peço|-lhes	Peço-lhes	Peço-|lhes|para|desligar
candidata-|se	candidata|-se	candidata-se	melhor|currículo|candidata-|se|a|o
mostrando-|se	mostrando|-se	mostrando-se	socorro|,|mostrando-|se|reticente|,
livrarmo-|nos	livrarmo|-nos	livrarmo-nos	lei|é|livrarmo-|nos|de|habitantes
reuniram-|se	reuniram|-se	reuniram-se	Eurocapital|,|reuniram-|se|,|em
perfilam-|se	perfilam|-se	perfilam-se	canal|,|perfilam-|se|,|de
disputar-|se	disputar|-se	disputar-se	está|a|disputar-|se|a|Taça
sentar-|se	sentar|-se	sentar-se	desejo|é|sentar-|se|em|o
dificultando-|lhe	dificultando|-lhe	dificultando-lhe	UNITA|,|dificultando-|lhe|o|cumprimento
ser-|se	ser|-se	ser-se	,|e|ser-|se|capaz|de
refugiou-|se	refugiou|-se	refugiou-se	primeiro|tempo|refugiou-|se|quase|sempre
faltou-|lhes	faltou|-lhes	faltou-lhes	,|mas|faltou-|lhes|inteligência|em
pronunciar-|se	pronunciar|-se	pronunciar-se	só|deverá|pronunciar-|se|dentro|de
servindo-|se	servindo|-se	servindo-se	»|,|servindo-|se|de|o
fazem-|no	fazem|-no	fazem-no	destino|,|fazem-|no|a|coberto
mostrou-|se	mostrou|-se	mostrou-se	viagem|e|mostrou-|se|mais|uma
exagerou-|se	exagerou|-se	exagerou-se	,|«|exagerou-|se|em|a
Abriu-|se	Abriu|-se	Abriu-se	Abriu-|se|a|Porta
auto-excluiu-|se	auto-excluiu|-se	auto-excluiu-se	excluída|ou|auto-excluiu-|se
inquietam-|se	inquietam|-se	inquietam-se	Os|mercados|inquietam-|se
apreciar-|se	apreciar|-se	apreciar-se	o|escudo|apreciar-|se|relativamente|a
aliam-|se	aliam|-se	aliam-se	Nacionais-comunistas|aliam-|se|contra
reunir-|se	reunir|-se	reunir-se	,|vão|reunir-|se|hoje|em
constata-|se	constata|-se	constata-se	)|,|constata-|se|que|desde
espera-|se	espera|-se	espera-se	Nirvana|,|espera-|se|ainda|a
viam-|se	viam|-se	viam-se	As|pessoas|viam-|se|obrigadas|a
vê-|se	vê|-se	vê-se	extremos|,|vê-|se|também|uma
apresenta-|se	apresenta|-se	apresenta-se	extra|,|apresenta-|se|o|Balt
Calcula-|se	Calcula|-se	Calcula-se	Calcula-|se|que|mais
dedicam-|se	dedicam|-se	dedicam-se	em|Portugal|dedicam-|se|a|a
adaptar-|se	adaptar|-se	adaptar-se	modo|a|adaptar-|se|a|a
digo-|lhe	digo|-lhe	digo-lhe	eu|pessoalmente|digo-|lhe|que|estou
autoparodiar-|se	autoparodiar|-se	autoparodiar-se	ironizar|e|autoparodiar-|se|sem|fazer
prejudica-|me	prejudica|-me	prejudica-me	colegas|,|prejudica-|me|a|mim
acentua-|se	acentua|-se	acentua-se	a|economia|acentua-|se
iniciou-|se	iniciou|-se	iniciou-se	coisas|,|iniciou-|se|uma|forte
Calcula-|se	Calcula|-se	Calcula-se	Calcula-|se|o|que
sabendo-|se	sabendo|-se	sabendo-se	escudo|,|sabendo-|se|,|como
curvei-|me	curvei|-me	curvei-me	«|Eu|curvei-|me|a|as
tornar-|se	tornar|-se	tornar-se	está|a|tornar-|se|«|amigo
destaca-|se	destaca|-se	destaca-se	temáticas|actuais|destaca-|se|a|presença
disse-|se	disse|-se	disse-se	em|Sines|disse-|se|pouco|e
fez-|se	fez|-se	fez-se	pouco|e|fez-|se|muito|»
suscitam-|me	suscitam|-me	suscitam-me	a|Expo-98|suscitam-|me|os|seguintes
repartir-|se	repartir|-se	repartir-se	incluídos|deverão|repartir-|se|entre|os
prepare-|se	prepare|-se	prepare-se	o|Transkei|prepare-|se|para|pagar
queixa-|se	queixa|-se	queixa-se	Cavaco|queixa-|se|de|o
venderam-|se	venderam|-se	venderam-se	preço|,|venderam-|se|quase|405
encontraram-|se	encontraram|-se	encontraram-se	Militantes|comunistas|encontraram-|se|em|público
doutorou-|se	doutorou|-se	doutorou-se	Açores|(|doutorou-|se|,|em
limita-|se	limita|-se	limita-se	Paiva|,|limita-|se|a|notar
Rodeaste-|te	Rodeaste|-te	Rodeaste-te	Rodeaste-|te|de|algum
detectaram-|se	detectaram|-se	detectaram-se	rede|digital|detectaram-|se|sismos|de
custa-|nos	custa|-nos	custa-nos	com|computadores|custa-|nos|um|bocado
aproximou-|se	aproximou|-se	aproximou-se	,|Jardim|aproximou-|se|de|a
devolvendo-|o	devolvendo|-o	devolvendo-o	Espanha|,|devolvendo-|o|a|os
foi-|se	foi|-se	foi-se	pouco|,|foi-|se|esquecendo|em
encontra-|se	encontra|-se	encontra-se	supernova|e|encontra-|se|em|expansão
trata-|se	trata|-se	trata-se	Valpayee|,|trata-|se|de|um
referindo-|se	referindo|-se	referindo-se	Kalam|,|referindo-|se|a|as
Deitou-|lhe	Deitou|-lhe	Deitou-lhe	Deitou-|lhe|para|cima
bater-|lhe	bater|-lhe	bater-lhe	Começou|a|bater-|lhe|com|um
Cortou-|lhe	Cortou|-lhe	Cortou-lhe	Cortou-|lhe|a|cabeça
Depenou-|a	Depenou|-a	Depenou-a	Depenou-|a
foi-|se	foi|-se	foi-se	caneta|e|foi-|se|embora
sentaram-|se	sentaram|-se	sentaram-se	muitos|australianos|sentaram-|se|a|o
levantaram-|se	levantaram|-se	levantaram-se	estudantes|e|levantaram-|se|para|gritar
Leu-|se	Leu|-se	Leu-se	Leu-|se|o|poeta
cantou-|se	cantou|-se	cantou-se	emoção|,|cantou-|se|«|Peace
juntem-|se	juntem|-se	juntem-se	Venham|e|juntem-|se|a|a
tornou-|se	tornou|-se	tornou-se	Santos|,|tornou-|se|popular|por
continua-|la	continuá|-la	continuá-la	bem|,|continua-|la
roubá-|la	roubá|-la	roubá-la	vem|«|roubá-|la|»
procederá-|se-	procederá|-se	proceder-se-á	,|procederá-|se-|a|a|criação
Via-|se	Via|-se	Via-se	Via-|se|que|,
chamou-|o	chamou|-o	chamou-o	a|juíza|chamou-|o|,|vendo
vende-|las	vendê|-las	vendê-las	Mas|poderia|vende-|las
registou-|se	registou|-se	registou-se	Frankfurt|,|registou-|se|uma|subida
tinha-|se	tinha|-se	tinha-se	Antes|,|tinha-|se|recusado|a
Pedia-|se	Pedia|-se	Pedia-se	Pedia-|se|62,50m|,
deslocarem-|se	deslocarem|-se	deslocarem-se	as|pessoas|deslocarem-|se|a|a
faze-|lo	fazê|-lo	fazê-lo	habituadas|a|faze-|lo|há|muitos
decidiu-|se	decidiu|-se	decidiu-se	resto|,|decidiu-|se|ainda|aumentar
propõem-|nos	propõem|-nos	propõem-nos	Foucault|,|propõem-|nos|uma|história
Trata-|se	Trata|-se	Trata-se	Trata-|se|de|uma
limitou-|se	limitou|-se	limitou-se	John|Major|limitou-|se|a|acompanhar
desvalorizar-|se	desvalorizar|-se	desvalorizar-se	a|libra|desvalorizar-|se
Trata-|se	Trata|-se	Trata-se	Trata-|se|de|um
espera-|se	espera|-se	espera-se	que|,|espera-|se|,|estejam
inteirar-|se	inteirar|-se	inteirar-se	ontem|a|inteirar-|se|de|os
ocupava-|se	ocupava|-se	ocupava-se	bem-comportado|e|ocupava-|se|em|trabalhos
Suicidou-|se	Suicidou|-se	Suicidou-se	Suicidou-|se|a|7
encontravam-|no	encontravam|-no	encontravam-no	9h30|,|encontravam-|no|enforcado|,
reconheceu-|me	reconheceu|-me	reconheceu-me	mim|e|reconheceu-|me|logo
Deu-|me	Deu|-me	Deu-me	Deu-|me|um|maço
sossegou-|me	sossegou|-me	sossegou-me	cigarros|e|sossegou-|me
Levaram-|me	Levaram|-me	Levaram-me	Levaram-|me|a|o
levar-|me	levar|-me	levar-me	gendarmes|decidirem|levar-|me|para|uma
abriram-|me	abriram|-me	abriram-me	seguinte|,|abriram-|me|a|porta
fizeram-|me	fizeram|-me	fizeram-me	cela|,|fizeram-|me|subir|umas
encontravam-|se	encontravam|-se	encontravam-se	mesa|trapezoidal|encontravam-|se|cinco|indivíduos
recusando-|se	recusando|-se	recusando-se	confirma|,|recusando-|se|a|pagar
demitir-|se	demitir|-se	demitir-se	nem|deve|demitir-|se|»
completam-|se	completam|-se	completam-se	certa|medida|completam-|se|»
pronunciar-|se	pronunciar|-se	pronunciar-se	chamados|a|pronunciar-|se|sobre|algo
abster-|se	abster|-se	abster-se	voltariam|a|abster-|se|de|ir
abster-|se	abster|-se	abster-se	volta|a|abster-|se|e|a
Referem-|se	Referem|-se	Referem-se	Referem-|se|a|normas
acentuar-|se	acentuar|-se	acentuar-se	mundial|deverá|acentuar-|se|já|em
opondo-|se	opondo|-se	opondo-se	1992|,|opondo-|se|,|de
distancia-|se	distancia|-se	distancia-se	Casa|Branca|distancia-|se|de
inscrever-|se	inscrever|-se	inscrever-se	,|podendo|inscrever-|se|em|a
Recorde-|se	Recorde|-se	Recorde-se	Recorde-|se|que|a
dividir-|se	dividir|-se	dividir-se	começam|a|dividir-|se|de|forma
dever-|se	dever|-se	dever-se	baixa|irá|dever-|se|principalmente|a
infectaram-|nos	infectaram|-nos	infectaram-nos	seguir|,|infectaram-|nos|com|o
inicia-|se	inicia|-se	inicia-se	particulares|--|inicia-|se|cronologicamente|em
contam-|se	contam|-se	contam-se	jóias|apresentadas|contam-|se|colares|de
Assinale-|se	Assinale|-se	Assinale-se	Assinale-|se|ainda|a
chateando-|se	chateando|-se	chateando-se	dobro|,|chateando-|se|por|a
inverte-|se	inverte|-se	inverte-se	Rua|Edison|inverte-|se|o|sentido
circular-|se	circular|-se	circular-se	passando|a|circular-|se|de|a
circulando-|se	circulando|-se	circulando-se	único|,|circulando-|se|de|a
Segue-|se	Segue|-se	Segue-se	Segue-|se|a|reunião
confirmarem-|se	confirmarem|-se	confirmarem-se	A|confirmarem-|se|os|confrontos
envolveram-|se	envolveram|-se	envolveram-se	Paquistão|,|envolveram-|se|em|uma
trocando-|o	trocando|-o	trocando-o	Unidos|,|trocando-|o|por|Abel
procurar-|se	procurar|-se	procurar-se	,|devendo|procurar-|se|ver|sempre
interrogar-|nos	interrogar|-nos	interrogar-nos	,|podemos|interrogar-|nos|como|foi
chamou-|se	chamou|-se	chamou-se	O|filme|chamou-|se|«|Objectivo
classificar-|se	classificar|-se	classificar-se	como|pode|classificar-|se|a|presença
limitou-|se	limitou|-se	limitou-se	BFE|,|limitou-|se|a|dizer
cotando-|se	cotando|-se	cotando-se	baixa|,|cotando-|se|em|os
fixar-|se	fixar|-se	fixar-se	a|o|fixar-|se|em|os
intermediaram-|se	intermediaram|-se	intermediaram-se	de|Lisboa|intermediaram-|se|10,592|milhões
optou-|se	optou|-se	optou-se	os|países|optou-|se|por|a
passa-|se	passa|-se	passa-se	a|infância|passa-|se|em|a
Sofrem-|nas	Sofrem|-nas	Sofrem-nas	Sofrem-|nas|umas|vezes
encaram-|nas	encaram|-nas	encaram-nas	em|outras|encaram-|nas|como|um
respondem-|lhes	respondem|-lhes	respondem-lhes	jogo|e|respondem-|lhes|jogando|também
prende-|se	prende|-se	prende-se	medida|preconizada|prende-|se|com|o
citam-|se	citam|-se	citam-se	o|relatório|citam-|se|os|elevados
disse-|nos	disse|-nos	disse-nos	senhor|presidente|disse-|nos|que|o
te-|lo	tê|-lo	tê-lo	não|podia|te-|lo|excluído|de
apaixonarem-|se	apaixonarem|-se	apaixonarem-se	cidade|a|apaixonarem-|se|perdidamente|por
tratar-|se	tratar|-se	tratar-se	Horta|disse|tratar-|se|de|uma
explicava-|se	explicava|-se	explicava-se	as|empresas|explicava-|se|como|se
arrisca-|se	arrisca|-se	arrisca-se	os|acusados|arrisca-|se|agora|a
realizaram-|se	realizaram|-se	realizaram-se	corrente|,|realizaram-|se|três|leilões
sofrê-|la	sofrê|-la	sofrê-la	Bem|basta|sofrê-|la|,|bem
reunir-|se	reunir|-se	reunir-se	associativos|irão|reunir-|se|com|o
acumulam-|se	acumulam|-se	acumulam-se	os|indícios|acumulam-|se|em|esse
verá-|se	verá|-se	ver-se-á	Outubro|,|verá-|se|se|estamos
Sobem-|se	Sobem|-se	Sobem-se	Sobem-|se|os|degraus
descem-|se	descem|-se	descem-se	sucesso|ou|descem-|se|,|em
serviu-|se	serviu|-se	serviu-se	O|PC|serviu-|se|de|a
interrompê-|la	interrompê|-la	interrompê-la	quer|a|interrompê-|la|,|deve
esboroar-|se	esboroar|-se	esboroar-se	que|poderá|esboroar-|se|totalmente|se
excluindo-|se	excluindo|-se	excluindo-se	--|,|excluindo-|se|de|esta
refugio-|me	refugio|-me	refugio-me	Traumatizado|,|refugio-|me|em|o
dão-|lhes	dão|-lhes	dão-lhes	flores|,|dão-|lhes|música|pimba
repetem-|se	repetem|-se	repetem-se	de|sincronismo|repetem-|se|com|enlouquecedora
declarar-|se	declarar|-se	declarar-se	seguinte|a|declarar-|se|,|dias
queixam-|se	queixam|-se	queixam-se	diplomatas|brasileiros|queixam-|se|de|a
considerar-|se	considerar|-se	considerar-se	que|podem|considerar-|se|fora|de
aguentar-|se	aguentar|-se	aguentar-se	que|consegue|aguentar-|se|em|o
serve-|se	serve|-se	serve-se	Itália|)|serve-|se|,|entre
cruzam-|se	cruzam|-se	cruzam-se	Holandês|--|cruzam-|se|e|fundem-
fundem-|se	fundem|-se	fundem-se	se|e|fundem-|se|a|partir
confirmar-|se	confirmar|-se	confirmar-se	,|a|confirmar-|se|,|apanhará
aproxima-|se	aproxima|-se	aproxima-se	A|data|aproxima-|se|,|há
manifestando-|se	manifestando|-se	manifestando-se	deputado|,|manifestando-|se|preocupado|com
reunir-|se	reunir|-se	reunir-se	voltam|a|reunir-|se|a|partir
deve-|se	deve|-se	deve-se	,|isto|deve-|se|a|todo
posiciona-|se	posiciona|-se	posiciona-se	mundial|,|posiciona-|se|agora|como
preocupar-|se	preocupar|-se	preocupar-se	que|devem|preocupar-|se|com|esse
imprimir-|lhes	imprimir|-lhes	imprimir-lhes	reformas|e|imprimir-|lhes|uma|orientação
ama-|lo	amá|-lo	amá-lo	continuarão|a|ama-|lo|quando|ele
roubar-|lhe	roubar|-lhe	roubar-lhe	dispostos|a|roubar-|lhe|o|terceiro
tem-|se	tem|-se	tem-se	esta|região|tem-|se|mantido|calma
seja-|se	seja|-se	seja-se	região|,|seja-|se|civil|ou
realiza-|se	realiza|-se	realiza-se	22h30|,|realiza-|se|o|II
presume-|se	presume|-se	presume-se	e|,|presume-|se|,|maiores
depararam-|se	depararam|-se	depararam-se	,|mas|depararam-|se|com|uma
passou-|se	passou|-se	passou-se	essas|atrocidades|passou-|se|há|60
trata-|se	trata|-se	trata-se	--|,|trata-|se|de|um
Trata-|se	Trata|-se	Trata-se	Trata-|se|de|facto
deslocar-|se	deslocar|-se	deslocar-se	,|deverá|deslocar-|se|hoje|a
formou-|se	formou|-se	formou-se	,|e|formou-|se|em|a
dá-|lhe	dá|-lhe	dá-lhe	última|sondagem|dá-|lhe|o|apoio
apresentou-|se	apresentou|-se	apresentou-se	o|Sporting|apresentou-|se|em|o
decidiu-|se	decidiu|-se	decidiu-se	Henrique|Calisto|decidiu-|se|,|por
encontra-|se	encontra|-se	encontra-se	,|Soares|encontra-|se|com|agricultores
encontra-|se	encontra|-se	encontra-se	Mafra|,|encontra-|se|de|novo
confirma-|a	confirma|-a	confirma-a	In|»|confirma-|a
tornou-|se	tornou|-se	tornou-se	,|1994|tornou-|se|um|ano
atribuindo-|o	atribuindo|-o	atribuindo-o	zona|,|atribuindo-|o|a|a
Recorde-|se	Recorde|-se	Recorde-se	Recorde-|se|que|as
apresenta-|se	apresenta|-se	apresenta-se	mais|,|apresenta-|se|como|o
dizendo-|lhe	dizendo|-lhe	dizendo-lhe	anfitrião|,|dizendo-|lhe|«|Não
atirando-|lhe	atirando|-lhe	atirando-lhe	...|e|atirando-|lhe|com|a
dividiam-|se	dividiam|-se	dividiam-se	as|opiniões|dividiam-|se|um|pouco
verificou-|se	verificou|-se	verificou-se	área|queimada|verificou-|se|em|o
reacender-|se	reacender|-se	reacender-se	voltou|a|reacender-|se|em|a
retirar-|nos	retirar|-nos	retirar-nos	que|queremos|retirar-|nos|de|o
respondem-|me	respondem|-me	respondem-me	imprensa|síria|respondem-|me|:|não
queixou-|se	queixou|-se	queixou-se	»|,|queixou-|se|Netanyahu
impede-|a	impede|-a	impede-a	prática|,|impede-|a|»
entregam-|se	entregam|-se	entregam-se	de|Matos|entregam-|se|com|tal
pensar-|se	pensar|-se	pensar-se	Chegou|a|pensar-|se|em|uma
telefonaram-|me	telefonaram|-me	telefonaram-me	,|e|telefonaram-|me
fez-|se	fez|-se	fez-se	nada|,|fez-|se|um|vazio
responde-|nos	responde|-nos	responde-nos	,|Whipp|responde-|nos|que|acha
fornecer-|lhe	fornecer|-lhe	fornecer-lhe	o|conjunto|fornecer-|lhe|um|novo
tratava-|se	tratava|-se	tratava-se	essencial|,|tratava-|se|de|a
encontrava-|se	encontrava|-se	encontrava-se	mas|,|encontrava-|se|em|o
exigiam-|lhe	exigiam|-lhe	exigiam-lhe	as|aulas|exigiam-|lhe|diariamente|um
fazer-|lhe	fazer|-lhe	fazer-lhe	,|resolveu|fazer-|lhe|uma|surpresa
oferecendo-|lhe	oferecendo|-lhe	oferecendo-lhe	surpresa|,|oferecendo-|lhe|umas|botas
tirava-|as	tirava|-as	tirava-as	ninguém|,|tirava-|as|e|ia
comprometeu-|se	comprometeu|-se	comprometeu-se	os|Açores|comprometeu-|se|a|pagar
destina-|se	destina|-se	destina-se	comprimento|,|destina-|se|a|o
Adivinha-|se	Adivinha|-se	Adivinha-se	Adivinha-|se|que|a
reunir-|se	reunir|-se	reunir-se	estado|a|reunir-|se|e|a
contam-|se	contam|-se	contam-se	28|expositores|contam-|se|as|autarquias
Vê-|se	Vê|-se	Vê-se	Vê-|se|que|este
tornar-|se	tornar|-se	tornar-se	cristianismo|iria|tornar-|se|a|religião
executa-|los	executá|-los	executá-los	e|ameaçou|executa-|los|caso|não
inicia-|se	inicia|-se	inicia-se	de|Brandão|inicia-|se|também|o
orgulhar-|se	orgulhar|-se	orgulhar-se	Jersey|pode|orgulhar-|se|de|ter
seguindo-|se	seguindo|-se	seguindo-se	futebolistas|,|seguindo-|se|o|Parma
tratar-|se	tratar|-se	tratar-se	que|deveria|tratar-|se|de|...
fazer-|me	fazer|-me	fazer-me	ter|conseguido|fazer-|me|entender|por
Diz-|se	Diz|-se	Diz-se	Diz-|se|que|um
torna-|se	torna|-se	torna-se	--|e|torna-|se|um|sucesso
aproximando-|se	aproximando|-se	aproximando-se	marcos|,|aproximando-|se|cautelosamente|de
valorizou-|se	valorizou|-se	valorizou-se	Paris|,|valorizou-|se|1,43|por
encontrava-|se	encontrava|-se	encontrava-se	a|sessão|encontrava-|se|em|alta
cotar-|se	cotar|-se	cotar-se	Jones|a|cotar-|se|em|os
torna-|se	torna|-se	torna-se	a|ASGFIM|torna-|se|,|em
torná-|lo	torná|-lo	torná-lo	forma|a|torná-|lo|mais|competitivo
descreve-|se	descreve|-se	descreve-se	os|visitantes|descreve-|se|com|uma
elevou-|se	elevou|-se	elevou-se	o|estrangeiro|elevou-|se|em|o
destinam-|se	destinam|-se	destinam-se	valores|registados|destinam-|se|a|o
elevou-|se	elevou|-se	elevou-se	turno|,|elevou-|se|a|298
chamando-|lhe	chamando|-lhe	chamando-lhe	Dias|,|chamando-|lhe|«|ex-camarada
recorde-|se	recorde|-se	recorde-se	»|(|recorde-|se|que|Oliveira
abeirou-|se	abeirou|-se	abeirou-se	)|,|abeirou-|se|de|Gomes
desculpou-|se	desculpou|-se	desculpou-se	O|presidente|desculpou-|se|,|lembrando-
lembrando-|lhe	lembrando|-lhe	lembrando-lhe	se|,|lembrando-|lhe|,|mais
dá-|me	dá|-me	dá-me	filho|,|dá-|me|um|abraço
aproxima-|se	aproxima|-se	aproxima-se	Observatório|,|aproxima-|se|de|os
tem-|se	tem|-se	tem-se	o|Governo|tem-|se|empenhado|em
entrega-|se	entrega|-se	entrega-se	vídeo|,|entrega-|se|a|a
inalá-|lo	inalá|-lo	inalá-lo	era|difícil|inalá-|lo|profundamente
ficava-|se	ficava|-se	ficava-se	o|fumo|ficava-|se|por|as
depositava-|se	depositava|-se	depositava-se	superiores|e|depositava-|se|em|a
levando-|o	levando|-o	levando-o	profundamente|,|levando-|o|mesmo|até
passeou-|se	passeou|-se	passeou-se	Pinochet|passeou-|se|por|Portugal
brindou-|os	brindou|-os	brindou-os	Comissão|Europeia|brindou-|os|com|as
lançou-|se	lançou|-se	lançou-se	o|indivíduo|lançou-|se|sobre|ela
tapou-|lhe	tapou|-lhe	tapou-lhe	ela|,|tapou-|lhe|a|boca
agrediu-|a	agrediu|-a	agrediu-a	boca|,|agrediu-|a|e|atirou-
atirou-|a	atirou|-a	atirou-a	a|e|atirou-|a|a|o
rasgou-|lhe	rasgou|-lhe	rasgou-lhe	Depois|rasgou-|lhe|a|roupa
valorizar-|se	valorizar|-se	valorizar-se	continuam|a|valorizar-|se|de|uma
inscreveu-|se	inscreveu|-se	inscreveu-se	Mais|tarde|inscreveu-|se|em|uma
mostra-|se	mostra|-se	mostra-se	José|Saldanha|mostra-|se|ainda|«
estabelecendo-|se	estabelecendo|-se	estabelecendo-se	professores|,|estabelecendo-|se|agora|novas
verifica-|se	verifica|-se	verifica-se	Depois|,|verifica-|se|uma|enorme
Ignora-|se	Ignora|-se	Ignora-se	Ignora-|se|qual|o
visitá-|la	visitá|-la	visitá-la	Excelência|a|visitá-|la
fica-|se	fica|-se	fica-se	,|hoje|fica-|se|por|os
revelar-|se	revelar|-se	revelar-se	que|poderá|revelar-|se|brilhante|e
ouviu-|se	ouviu|-se	ouviu-se	pneu|e|ouviu-|se|um|grande
tornou-|se	tornou|-se	tornou-se	Depois|,|tornou-|se|local|de
levantar-|se	levantar|-se	levantar-se	conseguem|sempre|levantar-|se|,|exigiram
avistou-|se	avistou|-se	avistou-se	Administração|Interna|avistou-|se|ontem|com
complicar-|se	complicar|-se	complicar-se	podem|todas|complicar-|se|,|caso
propõe-|se	propõe|-se	propõe-se	nova|equipa|propõe-|se|fazer|um
referindo-|se	referindo|-se	referindo-se	jornal|,|referindo-|se|a|a
deve-|se	deve|-se	deve-se	recolhido|,|deve-|se|a|a
propunham-|se	propunham|-se	propunham-se	Encontros|Acarte|propunham-|se|responder|a
mantê-|lo	mantê|-lo	mantê-lo	público|,|mantê-|lo|dentro|de
conduzi-|lo	conduzi|-lo	conduzi-lo	seja|necessário|conduzi-|lo|por|a
recorde-|se	recorde|-se	recorde-se	inspecções|,|recorde-|se|,|começaram
impõe-|se	impõe|-se	impõe-se	Belém|,|impõe-|se|como|imprescindível
relaciona-|se	relaciona|-se	relaciona-se	e|obviamente|relaciona-|se|com|o
difundiram-|se	difundiram|-se	difundiram-se	Os|Gopher|difundiram-|se|muito|rapidamente
classificaram-|se	classificaram|-se	classificaram-se	Filipe|Ochoa|classificaram-|se|para|a
pôde-|se	pôde|-se	pôde-se	»|,|pôde-|se|desde|logo
situando-|se	situando|-se	situando-se	Veneza|,|situando-|se|principalmente|a
apresentar-|se	apresentar|-se	apresentar-se	voltou|a|apresentar-|se|bastante|pressionada
revestir-|se	revestir|-se	revestir-se	Isso|poderia|revestir-|se|de|particular
reuniram-|se	reuniram|-se	reuniram-se	a|expedição|reuniram-|se|com|a
dizer-|se	dizer|-se	dizer-se	Podem|dizer-|se|coisas|muito
afastou-|se	afastou|-se	afastou-se	de|Palmela|afastou-|se|e|,
capitalizá-|la	capitalizá|-la	capitalizá-la	e|a|capitalizá-|la
situa-|se	situa|-se	situa-se	Adriana|Varejão|situa-|se|em|o
estabelecer-|se	estabelecer|-se	estabelecer-se	depende|de|estabelecer-|se|em|a
inclui-|se	inclui|-se	inclui-se	--|,|inclui-|se|,|como
matá-|la	matá|-la	matá-la	«|para|matá-|la|»|,
desvincular-|se	desvincular|-se	desvincular-se	94|poderá|desvincular-|se|de|o
desvincular-|se	desvincular|-se	desvincular-se	vir|a|desvincular-|se|de|o
encontrava-|se	encontrava|-se	encontrava-se	sangue|e|encontrava-|se|em|acelerado
encontra-|se	encontra|-se	encontra-se	Couto|Ferreira|encontra-|se|a|ser
ganha-|los	ganhá|-los	ganhá-los	--|pode|ganha-|los|se|os
joga-|los	jogá|-los	jogá-los	souber|«|joga-|los|»
tornar-|se	tornar|-se	tornar-se	»|a|tornar-|se|um|jornal
instalou-|se	instalou|-se	instalou-se	caminho|,|instalou-|se|em|a
bastar-|se	bastar|-se	bastar-se	populações|conseguem|bastar-|se|em|alimentos
preocupar-|se	preocupar|-se	preocupar-se	você|deveria|preocupar-|se|com|os
desertificar-|se	desertificar|-se	desertificar-se	está|a|desertificar-|se
desconhecendo-|se	desconhecendo|-se	desconhecendo-se	combate|,|desconhecendo-|se|até|que
faze-|lo	fazê|-lo	fazê-lo	Parlamento|a|faze-|lo|,|e
distanciarem-|se	distanciarem|-se	distanciarem-se	os|quarks|distanciarem-|se|o|suficiente
referindo-|se	referindo|-se	referindo-se	ele|,|referindo-|se|a|a
divertir-|nos	divertir|-nos	divertir-nos	que|íamos|divertir-|nos|e|que
Seguiu-|se	Seguiu|-se	Seguiu-se	Seguiu-|se|uma|troca
pronunciou-|se	pronunciou|-se	pronunciou-se	a|maioria|pronunciou-|se|por|o
passeou-|se	passeou|-se	passeou-se	falso|médico|passeou-|se|durante|por
avaliam-|se	avaliam|-se	avaliam-se	um|povo|avaliam-|se|por|a
iniciou-|se	iniciou|-se	iniciou-se	de|aquarofilia|iniciou-|se|ontem|com
contam-|se	contam|-se	contam-se	de|formação|contam-|se|entre|os
lançar-|se	lançar|-se	lançar-se	que|decidiu|lançar-|se|em|esta
situar-|se	situar|-se	situar-se	filme|deverão|situar-|se|entre|os
empenhar-|se	empenhar|-se	empenhar-se	)|a|empenhar-|se|em|propalar
foi-|me	foi|-me	foi-me	esse|direito|foi-|me|sempre|negado
disse-|me	disse|-me	disse-me	O|polícia|disse-|me|que|o
levantar-|se	levantar|-se	levantar-se	vozes|a|levantar-|se|em|a
sabe-|se	sabe|-se	sabe-se	o|menos|sabe-|se|onde|e
Queixa-|se	Queixa|-se	Queixa-se	Queixa-|se|a|o
afirmam-|se	afirmam|-se	afirmam-se	OLP|)|afirmam-|se|dispostos|a
mostrar-|se	mostrar|-se	mostrar-se	Voltando|a|mostrar-|se|particularmente|a
confirmou-|se	confirmou|-se	confirmou-se	pilotos|temiam|confirmou-|se|,|com
serve-|nos	serve|-nos	serve-nos	A|chuva|serve-|nos|perfeitamente|porque
regozijou-|se	regozijou|-se	regozijou-se	»|,|regozijou-|se|,|apesar
dotá-|lo	dotá|-lo	dotá-lo	,|visando|dotá-|lo|de|poderes
encaminhar-|se	encaminhar|-se	encaminhar-se	começam|a|encaminhar-|se|para|a
riem-|se	riem|-se	riem-se	aberto|e|riem-|se|de|os
Respirou-|se	Respirou|-se	Respirou-se	Respirou-|se|fundo|,
recriminam-|se	recriminam|-se	recriminam-se	chão|«|recriminam-|se|»|entre
seguiram-|se	seguiram|-se	seguiram-se	1m22,24s|,|seguiram-|se|a|a
separaram-|se	separaram|-se	separaram-se	escolar|,|separaram-|se|em|o
isolou-|se	isolou|-se	isolou-se	FC|Porto|isolou-|se|em|o
tratando-|se	tratando|-se	tratando-se	»|,|tratando-|se|de|«
Encontra-|se	Encontra|-se	Encontra-se	Encontra-|se|cortada|em
iniciar-|se	iniciar|-se	iniciar-se	ano|vai|iniciar-|se|como|escola
prevendo-|se	prevendo|-se	prevendo-se	internacionalização|,|prevendo-|se|apenas|«
Fez-|lo	Fê|-lo	Fê-lo	Fez-|lo|ontem|,
mandar-|las	mandá|-las	mandá-las	)|e|mandar-|las|em|a
despedia-|se	despedia|-se	despedia-se	nome|e|despedia-|se|com|um
descreverem-|se	descreverem|-se	descreverem-se	vida|a|descreverem-|se|uns|a
encontra-|se	encontra|-se	encontra-se	a|China|encontra-|se|«|em
obrigando-|os	obrigando|-os	obrigando-os	cesto|,|obrigando-|os|a|um
injectar-|se	injectar|-se	injectar-se	precisariam|de|injectar-|se|em|os
integrou-|se	integrou|-se	integrou-se	confiante|,|integrou-|se|bem|em
assistiu-|se	assistiu|-se	assistiu-se	anos|,|assistiu-|se|a|um
disse-|nos	disse|-nos	disse-nos	Orçamento|]|disse-|nos|que|quando
apresentou-|se	apresentou|-se	apresentou-se	Monetário|Interbancário|apresentou-|se|logo|em
Trata-|se	Trata|-se	Trata-se	Trata-|se|de|uma
apressou-|se	apressou|-se	apressou-se	Clinton|apressou-|se|a|dizer
conta-|se	conta|-se	conta-se	primeiros|,|conta-|se|o|advogado
realizar-|se	realizar|-se	realizar-se	que|deverá|realizar-|se|em|uma
concluir-|se	concluir|-se	concluir-se	como|pode|concluir-|se|por|as
desviar-|se	desviar|-se	desviar-se	tem|de|desviar-|se|de|autênticas
ajudando-|os	ajudando|-os	ajudando-os	pilotos|,|ajudando-|os|sempre|que
queixa-|se	queixa|-se	queixa-se	decreto|e|queixa-|se|de|ter
agrada-|me	agrada|-me	agrada-me	A|ideia|agrada-|me|e|já
demitiu-|se	demitiu|-se	demitiu-se	Honra|,|demitiu-|se|em|bloco
pode-|se	pode|-se	pode-se	«|logo|pode-|se|concluir|que
verificar-|se	verificar|-se	verificar-se	venha|a|verificar-|se|,|a
revela-|se	revela|-se	revela-se	acaso|,|revela-|se|alguém|que
recandidatar-|se	recandidatar|-se	recandidatar-se	caso|decida|recandidatar-|se
reuniu-|se	reuniu|-se	reuniu-se	Branca|,|reuniu-|se|por|a
impôs-|se	impôs|-se	impôs-se	E|)|impôs-|se|com|1m51,484s
Agarrou-|se	Agarrou|-se	Agarrou-se	Agarrou-|se|a|a
Trata-|se	Trata|-se	Trata-se	Trata-|se|de|o
sendo-|se	sendo|-se	sendo-se	difícil|,|sendo-|se|fotógrafo|,
sendo-|se	sendo|-se	sendo-se	ainda|,|sendo-|se|fotojornalista|,
Vejam-|se	Vejam|-se	Vejam-se	Vejam-|se|as|suas
consegue-|o	consegue|-o	consegue-o	Ele|consegue-|o
faz-|lo	fá|-lo	fá-lo	,|mas|faz-|lo|sem|pragmatismo
mostrar-|nos	mostrar|-nos	mostrar-nos	não|seja|mostrar-|nos|o|que
opor-|se	opor|-se	opor-se	metalúrgica|a|opor-|se|a|a
proporcionar-|lhe	proporcionar|-lhe	proporcionar-lhe	é|conveniente|proporcionar-|lhe|essa|estimulação
iniciou-|se	iniciou|-se	iniciou-se	Depois|,|iniciou-|se|a|colaboração
fazia-|se	fazia|-se	fazia-se	O|trabalho|fazia-|se|em|o
citem-|se	citem|-se	citem-se	exemplo|,|citem-|se|originais|(
Tendo-|se	Tendo|-se	Tendo-se	Tendo-|se|tornado|difícil
reúne-|se	reúne|-se	reúne-se	o|PS|reúne-|se|em|a
Trata-|se	Trata|-se	Trata-se	Trata-|se|,|segundo
deram-|se	deram|-se	deram-se	tragédias|artísticas|deram-|se|com|as
debater-|se	debater|-se	debater-se	continua|a|debater-|se|com|o
Esperam-|se	Esperam|-se	Esperam-se	Esperam-|se|,|agora
desenvolve-|se	desenvolve|-se	desenvolve-se	a|equipa|desenvolve-|se|sempre|muito
pensar-|se	pensar|-se	pensar-se	princípio|chegou|pensar-|se|instalar|um
perdeu-|se	perdeu|-se	perdeu-se	descontraído|,|perdeu-|se|a|contar
torná-|la	torná|-la	torná-la	rede|,|torná-|la|agradável|e
fazia-|nos	fazia|-nos	fazia-nos	Este|fazia-|nos|acreditar|que
Recorde-|se	Recorde|-se	Recorde-se	Recorde-|se|aliás|que
trata-|se	trata|-se	trata-se	trata-|se|de|as
lê-|se	lê|-se	lê-se	o|programa|lê-|se|que|ele
refere-|se	refere|-se	refere-se	O|texto|refere-|se|,|nomeadamente
queixa-|se	queixa|-se	queixa-se	freguesia|,|queixa-|se|também|de
sustenta-|se	sustenta|-se	sustenta-se	de|Brandão|sustenta-|se|em|uma
interroga-|se	interroga|-se	interroga-se	falsas|e|interroga-|se
Aguarda-|se	Aguarda|-se	Aguarda-se	Aguarda-|se|que|o
Sustêm-|se	Sustêm|-se	Sustêm-se	Sustêm-|se|as|respirações
encontram-|se	encontram|-se	encontram-se	primária|e|encontram-|se|em|a
custaram-|lhe	custaram|-lhe	custaram-lhe	As|críticas|custaram-|lhe|o|exílio
Reencontrou-|se	Reencontrou|-se	Reencontrou-se	Reencontrou-|se|com|o
referia-|se	referia|-se	referia-se	Jaime|Gama|referia-|se|a|um
apresentá-|lo	apresentá|-lo	apresentá-lo	se|pretender|apresentá-|lo|»
Trata-|se	Trata|-se	Trata-se	Trata-|se|de|a
portava-|se	portava|-se	portava-se	si|,|portava-|se|como|um
Aproximou-|se	Aproximou|-se	Aproximou-se	Aproximou-|se|e|o
Subiram-|lhe	Subiram|-lhe	Subiram-lhe	Subiram-|lhe|as|lágrimas
esquivou-|se	esquivou|-se	esquivou-se	O|outro|esquivou-|se|delicadamente|,
convidou-|o	convidou|-o	convidou-o	,|mas|convidou-|o|a|subir
seguindo-|se	seguindo|-se	seguindo-se	procura|,|seguindo-|se|então|o
deslocar-|se	deslocar|-se	deslocar-se	mesmo|a|deslocar-|se|a|as
disse-|nos	disse|-nos	disse-nos	»|,|disse-|nos|o|homem
mostrou-|se	mostrou|-se	mostrou-se	Ferro|Rodrigues|mostrou-|se|descontente|com
revelou-|se	revelou|-se	revelou-se	realizador|)|revelou-|se|bastante|interessante
Fazia-|se	Fazia|-se	Fazia-se	Fazia-|se|passar|por
simplificam-|se	simplificam|-se	simplificam-se	As|letras|simplificam-|se|,|para
tratando-|se	tratando|-se	tratando-se	inconsistente|,|tratando-|se|afinal|de
deslocou-|se	deslocou|-se	deslocou-se	Pedro|Conceição|deslocou-|se|a|a
dize-|lo	dizê|-lo	dizê-lo	minha|parte|dize-|lo|,|posso
justifica-|se	justifica|-se	justifica-se	»|,|justifica-|se|em|uma
aliou-|se	aliou|-se	aliou-se	o|sonho|aliou-|se|a|a
reconhecendo-|se	reconhecendo|-se	reconhecendo-se	lado|,|reconhecendo-|se|,|incapaz
propõem-|se	propõem|-se	propõem-se	sem|Fronteiras|propõem-|se|,|para
envolver-|se	envolver|-se	envolver-se	já|,|envolver-|se|em|a
mantê-|los	mantê|-los	mantê-los	moral|para|mantê-|los|escravizados
aprova-|se	aprova|-se	aprova-se	Primeiro|aprova-|se|o|texto
negocia-|se	negocia|-se	negocia-se	e|depois|negocia-|se|a|aprovação
mostrando-|se	mostrando|-se	mostrando-se	que|acabaram|mostrando-|se|vulneráveis
tê-|la	tê|-la	tê-la	Claudirene|de|tê-|la|estuprado|em
Pode-|se	Pode|-se	Pode-se	Pode-|se|agora|recomendar
distribuir-|los	distribuí|-los	distribuí-los	produtos|para|distribuir-|los|a|seus
provocou-|me	provocou|-me	provocou-me	Aquele|pensamento|provocou-|me|um|arrepio
confrontando-|se	confrontando|-se	confrontando-se	antepassada|e|confrontando-|se|,|por
comunicou-|lhe	comunicou|-lhe	comunicou-lhe	mesquinha|,|comunicou-|lhe|que|,
Trata-|se	Trata|-se	Trata-se	Trata-|se|de|o
dirigiu-|se	dirigiu|-se	dirigiu-se	aeroporto|e|dirigiu-|se|a|o
produzi-|lo	produzi|-lo	produzi-lo	intenção|de|produzi-|lo|ou|sequer
tornara-|se	tornara|-se	tornara-se	Simplesmente|tornara-|se|impossível|,
convertera-|se	convertera|-se	convertera-se	Tal|política|convertera-|se|,|com
depara-|se	depara|-se	depara-se	de|preços|depara-|se|agora|mais
encontra-|se	encontra|-se	encontra-se	Vital|Borkelmans|encontra-|se|também|com
acariciar-|lhe	acariciar|-lhe	acariciar-lhe	sorte|a|acariciar-|lhe|a|cara
limitou-|se	limitou|-se	limitou-se	o|episódio|limitou-|se|a|um
diga-|se	diga|-se	diga-se	mercado|,|diga-|se|é|o
referindo-|se	referindo|-se	referindo-se	afirmou|,|referindo-|se|a|a
divulgá-|las	divulgá|-las	divulgá-las	,|ao|divulgá-|las|sem|uma
localizá-|lo	localizá|-lo	localizá-lo	foi|possível|localizá-|lo|e|descobrir
coordená-|la	coordená|-la	coordená-la	cotado|para|coordená-|la|é|o
Deve-|se	Deve|-se	Deve-se	Deve-|se|usar|pedras
arriscar-|me	arriscar|-me	arriscar-me	é|para|arriscar-|me|em|a
Entregar-|se	Entregar|-se	Entregar-se	Entregar-|se|,|com
diga-|se	diga|-se	diga-se	história|,|diga-|se|que|o
medi-|lo	medi|-lo	medi-lo	você|tentar|medi-|lo|,|estará
leva-|os	leva|-os	leva-os	escândalos|,|leva-|os|,|também
Trata-|se	Trata|-se	Trata-se	Trata-|se|de|o
tê-|lo	tê|-lo	tê-lo	contente|por|tê-|lo|«|de
incluindo-|se	incluindo|-se	incluindo-se	km/h|,|incluindo-|se|a|espera
encontra-|se	encontra|-se	encontra-se	José|Sarney|encontra-|se|por|o
baseia-|se	baseia|-se	baseia-se	O|cálculo|baseia-|se|em|a
acode-|nos	acode|-nos	acode-nos	Menininha|,|acode-|nos|em|esta
dá-|no	dá|-no	dá-no	desespero|,|dá-|no|o|alimento
deve-|se	deve|-se	deve-se	pesquisa|Datafolha|deve-|se|a|a
encerram-|se	encerram|-se	encerram-se	mês|,|encerram-|se|as|inscrições
submeter-|se	submeter|-se	submeter-se	,|vai|submeter-|se|a|uma
limitou-|se	limitou|-se	limitou-se	O|ministro|limitou-|se|a|dizer
reintegrá-|lo	reintegrá|-lo	reintegrá-lo	ser|para|reintegrá-|lo|em|a
Desculpe-|se	Desculpe|-se	Desculpe-se	Desculpe-|se
esboça-|se	esboça|-se	esboça-se	março|,|esboça-|se|a|mesma
render-|se	render|-se	render-se	um|partido|render-|se|tão|rápida
trata-|se	trata|-se	trata-se	ele|,|trata-|se|de|regime
encontra-|se	encontra|-se	encontra-se	o|México|encontra-|se|em|uma
Tome-|se	Tome|-se	Tome-se	Tome-|se|o|caso
Afirma-|o	Afirma|-o	Afirma-o	Afirma-|o|,|de
aplica-|se	aplica|-se	aplica-se	simples|:|aplica-|se|um|reajuste
avalia-|se	avalia|-se	avalia-se	seguida|,|avalia-|se|qual|a
assustou-|se	assustou|-se	assustou-se	o|ex-presidente|assustou-|se|com|os
aprová-|lo	aprová|-lo	aprová-lo	não|quer|aprová-|lo|agora|,
estendendo-|a	estendendo|-a	estendendo-a	,|e|estendendo-|a|sobre|o
Trata-|se	Trata|-se	Trata-se	«|Trata-|se|de|um
abstraindo-|se	abstraindo|-se	abstraindo-se	Mesmo|abstraindo-|se|tudo|o
deve-|se	deve|-se	deve-se	Mas|deve-|se|tomar|o
estima-|se	estima|-se	estima-se	mercado|,|estima-|se|que|as
aprofundou-|se	aprofundou|-se	aprofundou-se	o|MG|aprofundou-|se|em|o
encontra-|se	encontra|-se	encontra-se	hoje|,|encontra-|se|em|uma
deslocar-|se	deslocar|-se	deslocar-se	é|necessário|deslocar-|se|muito|a
revelaram-|se	revelaram|-se	revelaram-se	,|47|revelaram-|se|positivas|em
acirrou-|se	acirrou|-se	acirrou-se	lado|,|acirrou-|se|a|reação
incluiam-|se	incluiam|-se	incluiam-se	as|quais|incluiam-|se|a|televisão
torna-|se	torna|-se	torna-se	reformas|,|torna-|se|muito|mais
fazê-|los	fazê|-los	fazê-los	mais|difícil|fazê-|los|aprovar|em
Trata-|se	Trata|-se	Trata-se	Trata-|se|de|outra
Somando-|se	Somando|-se	Somando-se	Somando-|se|os|dois
chega-|se	chega|-se	chega-se	números|,|chega-|se|a|500
destacam-|se	destacam|-se	destacam-se	centers|)|destacam-|se|por|a
juntou-|se	juntou|-se	juntou-se	senador|,|juntou-|se|a|o
apanhá-|los	apanhá|-los	apanhá-los	para|eu|apanhá-|los|e|para
verifica-|se	verifica|-se	verifica-se	93|,|verifica-|se|aumento|de
vacinar-|la	vaciná|-la	vaciná-la	,|basta|vacinar-|la|contra|as
fazer-|lo	fazê|-lo	fazê-lo	Como|poderá|fazer-|lo|,|porém
trata-|se	trata|-se	trata-se	vê|,|trata-|se|de|questões
institucionalizou-|se	institucionalizou|-se	institucionalizou-se	politicamente|correto|institucionalizou-|se|,|mas
convidando-|os	convidando|-os	convidando-os	empresas|«|convidando-|os|»|a
destroçar-|la	destroçá|-la	destroçá-la	ou|pode|destroçar-|la|em|o
levou-|o	levou|-o	levou-o	os|EUA|levou-|o|a|conhecer
afiou-|o	afiou|-o	afiou-o	forma|,|afiou-|o|para|a
Trata-|se	Trata|-se	Trata-se	Trata-|se|de|uma
rebelar-|se	rebelar|-se	rebelar-se	pronta|para|rebelar-|se|por|a
fazer-|lo	fazê|-lo	fazê-lo	mas|podem|fazer-|lo|em|rajadas
trocando-|os	trocando|-os	trocando-os	estaduais|,|trocando-|os|por|títulos
pode-|se	pode|-se	pode-se	exemplo|,|pode-|se|entrar|em
desagradá-|la	desagradá|-la	desagradá-la	pessoa|sem|desagradá-|la|em|o
leia-|se	leia|-se	leia-se	o|PFL|leia-|se|ACM|está
Pode-|se	Pode|-se	Pode-se	Pode-|se|dizer|,
Trata-|se	Trata|-se	Trata-se	Trata-|se|de|o
coligou-|se	coligou|-se	coligou-se	PFL|,|coligou-|se|em|torno
tornando-|as	tornando|-as	tornando-as	canções|acaba|tornando-|as|filhotes|de
Tratava-|se	Tratava|-se	Tratava-se	Tratava-|se|de|um
Tratavam-|se	Tratavam|-se	Tratavam-se	Tratavam-|se|de|contribuições
arrastá-|la	arrastá|-la	arrastá-la	termina|por|arrastá-|la|destestavelmente|,
cumprir-|la	cumpri|-la	cumpri-la	de|fato|cumprir-|la
ter-|se	ter|-se	ter-se	depois|de|ter-|se|transformado|em
encerrou-|se	encerrou|-se	encerrou-se	campanha|eleitoral|encerrou-|se|em|a
chama-|se	chama|-se	chama-se	Evening|»|chama-|se|«|I
nomear-|lo	nomeá|-lo	nomeá-lo	acaba|de|nomear-|lo|para|o
chama-|se	chama|-se	chama-se	dança|hoje|chama-|se|«|Central
Inspira-|se	Inspira|-se	Inspira-se	«|Inspira-|se|em|o
apunha-|lhe	apunha|-lhe	apunha-lhe	canção|e|apunha-|lhe|título|e
irritou-|se	irritou|-se	irritou-se	O|técnico|irritou-|se|com|uma
tornar-|se	tornar|-se	tornar-se	rock'n'roll|para|tornar-|se|o|símbolo
deve-|se	deve|-se	deve-se	cassações|,|deve-|se|estimular|as
dando-|lhe	dando|-lhe	dando-lhe	ajuda|,|dando-|lhe|uma|cela
unia-|se	unia|-se	unia-se	URSS|)|unia-|se|contra|o
desconfiava-|se	desconfiava|-se	desconfiava-se	Washington|,|desconfiava-|se|de|Getúlio
aliar-|se	aliar|-se	aliar-se	,|ou|aliar-|se|com|os
libertá-|lo	libertá|-lo	libertá-lo	)|para|libertá-|lo
fala-|se	fala|-se	fala-se	exemplo|,|fala-|se|muito|sobre
citando-|o	citando|-o	citando-o	ser|bacana|citando-|o|como|a
encaixá-|lo	encaixá|-lo	encaixá-lo	Itamar|quis|encaixá-|lo|em|o
detê-|lo	detê|-lo	detê-lo	polícia|em|detê-|lo|como|exemplo
Aventure-|se	Aventure|-se	Aventure-se	Aventure-|se|em|o
queixar-|se	queixar|-se	queixar-se	ontem|para|queixar-|se|de|as
Habite-|se	Habite|-se	Habite-se	Habite-|se
recuperou-|se	recuperou|-se	recuperou-se	mas|logo|recuperou-|se
dão-|se	dão|-se	dão-se	Enchentes|dão-|se|por|o
fala-|se	fala|-se	fala-se	Real|,|fala-|se|de|posições
Trata-|se	Trata|-se	Trata-se	Trata-|se|,|segundo
quebrar-|lo	quebrá|-lo	quebrá-lo	de|«|quebrar-|lo|»|com
convencê-|los	convencê|-los	convencê-los	e|a|convencê-|los|de|fazer
Passaram-|se	Passaram|-se	Passaram-se	Passaram-|se|uns|50
atendê-|los	atendê|-los	atendê-los	conta|de|atendê-|los
confirma-|se	confirma|-se	confirma-se	)|,|confirma-|se|que|os
promovendo-|se	promovendo|-se	promovendo-se	drogas|,|promovendo-|se|um|comportamento
Iniciei-|me	Iniciei|-me	Iniciei-me	Iniciei-|me|com|uma
dediquei-|me	dediquei|-me	dediquei-me	,|e|dediquei-|me|com|carinho
segui-|lhe	segui|-lhe	segui-lhe	France|2|segui-|lhe|os|passos
saldaram-|se	saldaram|-se	saldaram-se	os|resultados|saldaram-|se|por|um
explica-|se	explica|-se	explica-se	a|empresa|explica-|se|,|em
escusou-|se	escusou|-se	escusou-se	Estrangeiros|português|escusou-|se|a|ser
transformarem-|se	transformarem|-se	transformarem-se	Tomates|a|transformarem-|se|em|a
Veja-|se	Veja|-se	Veja-se	Veja-|se|,|a
privilegia-|se	privilegia|-se	privilegia-se	prática|,|privilegia-|se|as|intervenções
ilustrá-|lo	ilustrá|-lo	ilustrá-lo	A|ilustrá-|lo|o|exemplo
causa-|me	causa|-me	causa-me	«|Pessoalmente|causa-|me|alguma|perplexidade
debruçar-|se	debruçar|-se	debruçar-se	levado|a|debruçar-|se|e|espreitar
mostram-|nos	mostram|-nos	mostram-nos	fim|,|mostram-|nos|esculturas|que
Acabou-|se	Acabou|-se	Acabou-se	Acabou-|se|a|gestão
mobilizar-|se	mobilizar|-se	mobilizar-se	a|sociedade|mobilizar-|se|para|sensibilizar
